NO ./assets/textures/NO.png
SO ./assets/textures/SO.png
WE ./assets/textures/WE.png
EA ./assets/textures/EA.png

F 85,85,85
C 185,217,235

11111111111111111111111111111111111111
10101001010101010101010101010101010101
10000000000000000000000000000000000001
10101001010101010101010101010101010101
10000000000000000000000000000000000001
10101001010101010101010101010101010101
10000000000000000000000000000000000001
10101001010101010101010101010101010101
1N000000000000000000000000000000000001
10101001010101010101010101010101010101
11111111111111111111111111111111111111
